13
13
#############
#I    #   ###
###### ### ##
#S######### #
# ######### #
# ######### #
# ######### #
## ####### ##
### ##### ###
#### ### ####
##### # #####
###### ######
#############