10
9
##########
#I       #
# # # ## #
# # # ## #
# ### ## #
# #S     #
# ###### #
#        #
##########