15
10
###############
#I## ##########
## ############
## ### ########
## ## #########
###  ##########
### ###########
####    #######
########   S###
###############
