12
10
############
#I### #  # #
# ## # #####
##  # ### ##
#  ## ## ###
# ## ###  ##
# #  ## # ##
## ##  # ###
# # #  #  S#
############
